XXXXXXXXXXXXXX
X*XXX XXXXXXXX
X            X
X XX XXXXX XXX
XXXXXXX@   XXX
X     XXXXXXXX
XXXXXXXXXXXXXX